81 20 20
* **     **    ** * 
*   * *****2    *#* 
 *# * #** *  * * 1  
 *          * * # * 
3   *  *  *    **##*
 ** ###  ## #  *** #
   *# ##  *#* *  # *
 * *   *  *   #*  *#
*  *    * *   **    
 1#   *      *   1  
   1* *   #*p      *
*** *  **#*   * # 2#
  * *** #   *  2   *
        **## ## ##  
# #  #  1 #     *#  
*  *      *      #* 
# # *  # ## *   *   
#    3*   *  * * *#*
 *  *   *     *#    
*#   * # *     *# # 