603 20 20
#** * **  #    * ** 
# # ## **  1  *   1 
*  *#*  1       *   
     #*   *  p **   
*   3 #   *#  #* #*#
 *###  ***#  **    *
        #   * #  1**
 ## # * # *  # #* # 
**  ###**3 *  #** 3 
 * #*  #*  ** * #  #
 *#  #  **3  ** ** *
 2  **  #   1  *  * 
*    *** *  *   2*  
 #2 **  # * #  # #* 
    *   *  *  #*    
*** *****    2 ** # 
  3   *  * #  * #  3
#   **# 3 *     3   
 * 2  #   3   *    *
 *    **   *#*    3 