91 20 20
  ** * * #  * *# **#
*#*# *  **#  #  *   
*  *#**#   #     *# 
  #*    ##  *2  * * 
    *# *  #   *** # 
##     * *     **  1
 #*          * ***  
#*#**  # **  *#**   
 * #* 1  *  *       
*   2 * ** #* * #** 
     * #* **  3  * 1
  *    *        2 * 
*  p  * # **     *  
    * # *   *    ***
#        ##1        
 *  *#   ## #* *** #
  ** *   #* ##    *#
 ###    *  # 1 ** * 
#*  *   #  *     *  
#  **  #  **  3 *   