90 20 20
  *  *          *##*
*#   ** ##     #  # 
   #  * **      * 2 
 *  3   ** #***  #  
 **#*        1 ##   
          *##   *#  
 # ** #* *   ** *## 
  * # * * ** **   * 
*# *  * * #* *#   *#
 *    #  #  *    ** 
# 1 #  1 #**#  *#* #
  #  *   *** #*   **
      *  ## **# *# *
**  ** * *   # 3    
  **   *# 2***   ** 
 *# ###    #*  **   
#    **   *  *  *   
 *1  **     #    1 #
   **  * *# *p  *   
*  * 2            **