62 20 20
      *  *       ** 
*     * *  * *  *## 
 * * #*# #     *   *
 ***   2   *  *  *  
 *    *   # *#*#*  *
# 1  #*#*  **  #    
 #* *      #    # 2 
  #2 # * ** # #*    
 #*  #**  *#  **    
*##   *  * *#*   #  
  # *  *    *   p  *
 *    #   ** * **   
   ** ** * *  *# 1  
 ** *** **  #*  # * 
## ## *   *   **#*  
 # * * #*    1  *   
* # *   #*#  *   **#
* *  3*  #*##  #* 1 
 #  *  #         *  
*  3 **#  1     * # 