459 20 20
* *   **    #     #*
##  ***  *  *   #***
**  #***  # *   ****
**#  #  #* 3 # *   *
 #   #  * #* #   ###
 2 *  3#   #  **** #
# *  *  # *  * *  3 
*   *  #   2 # *    
 #*** *     # ***   
 *** * *  #  *# #*# 
 *   # *3 * 3  p  #*
 2    #* *#     *   
*  1*   ##       1  
    *** # * 1* **   
 *# * *   1   #   * 
** *# **    #  #*  3
   * *     3# ** ** 
3 #*  1  #  *3  3 * 
    *  *  2** #* ***
 2      #     #    #