880 20 20
*         *# *   #  
   1    * **    2 # 
      #### ** #     
*#** *     *   * *# 
*** *  **# ## 3* # *
*# #  *     #  *  * 
 * ###*** 2*** *    
  *  *   *  * 2   **
   3  **     * * *  
 3 *#  *   #* *# ## 
***#  1   **  #### 2
   #*  * ****  3 *  
 2 *   * *##  *    *
  * 3 #  *    1 **  
* #  * *  3     # *#
**#1  3* *# * #  #  
* * *   3 *   *   * 
  *  #*# * * *   p  
* ***#  * 1  #3  #*#
*     #* ## *   3   