959 20 20
 ##*           *    
* *# *  3  *##** * 3
   *  ## # ** # * * 
*  #   *  1 * # #   
** 2  p     *3   # #
    *  *3 *#  * 3*# 
***** #   *  #    * 
 #  *  1  *   *    *
 *   *   **2    *** 
  # ** #3 * ** 2   3
#*  #  * #    # **  
# #    #*  **   2   
 * ** *   ***  #    
**  #  **#*#  3  *1 
 *    *   #*##  3   
    *  * 1  * ##  * 
 **  * *# *3   #*  *
 # 1  * #*#  *****  
 *# *#*#      *  # #
***#   * #* #  2 * *