479 20 20
*    # #  * * *  2  
 3  3##** 3 * *##  3
 * * * # #    #*# * 
* **# 3## *  2   ** 
*# *      #p * #* #*
#*1  #  *    #1     
#  *   * *   #   1**
*# ***    * #       
 **  **2 # 3*  ## 2 
 #*     * *   #**# *
       # #* *     * 
 **   * ***   * *   
*  * *#   #*   # ** 
 3  * # * *  * 1 #  
 * #* * **  2*#     
  3 **  #**      * *
 *       * * ***# * 
 *  3   #  ** *  # #
    # * #* *  * 3  #
*# ** #  *  1 #    *