998 20 20
 ****   ### 1  *    
2    3    *    * *  
  3  #  * **  #*  *#
* # 3  3  1    **  *
 #*#    *       3 * 
*  **  # #   p** *  
* *  # ** **# #   3 
* **  #  ##  *  ### 
 *  3 #*#  *  * ** *
  *# * * **      ** 
  *   ** # *  2   * 
    * *# * #*  *    
2 #1     2 *   ** # 
    * ***   # #  3**
##   #*  #*#   *  # 
  1 #  #*   * 3 * * 
# *# #*#* 1  *  *#  
*#*    **   3*#   **
  # * * * #*  ****  
** # 2  * * #      #