93 20 20
     #*#       *    
 3 ****  #   * ##* *
  * #*** * 1** *  # 
*   *   #   #*   ** 
* *   *       #* *  
#* #* # * 1 ## *    
   *    # *   #**#* 
#*     * ** *     * 
     # ** * #* * 2 #
 *  *  *  **     *  
   *  #    *# * 2  *
* * *     3 *    #  
    # #    #**   ** 
  ** * #**#    1 ** 
  *#** *##      *  *
  * *  1  * #  # #**
* p  #   *     2 *  
*  *#    1 ##**   #*
   *      * * # *  #
##  *# *# #* # **  #