3 20 20
  # *     p ##*   #*
*1      **  *  ** * 
* #  *   *#  *      
**    *# #*#  # *  *
 *   **# *    *  #* 
   # #  * #  *  **  
# *  * 1 *## #    * 
    *   *    * *   #
  # * *    #   *** *
 *  ***    *** # *  
    * *      *##*   
*  *# #  *   #* #  *
 *    **  #2        
1 **          **1 * 
  ## * * #*  *    # 
    # **   *** * ** 
     # #*** #    #  
  **  **   *#**   **
 #   2 *##  # #  *# 
  *#  ##  * ** *#   