9 20 20
    ##* *  ** *#*  *
 p  *#*   ##  * #  *
 * *#*  2 #* * *  ##
  *   ##* 1  1 # #* 
* # 1  *   **      *
   * *** #   * * *  
  *#   *  #  # *  * 
 **    #  #*     ** 
  *  *     * ** ***#
 #      #      *    
* # * 2  *** * 1 * #
  *  *#  *  *    * *
# #**   # #  ***    
  *   ***    #  # * 
*#*   * # 2 **     *
### # *   #         
# # # #*  *  *  *2  
#    #*  * *   *  **
  **  ** #       #  
   * *#  *  * * *   