75 20 20
  *** ** # **  ** * 
 ##   #  *# #   2  #
#*      #*  1      *
#*   * *# #*        
 * *** **  **  *  1 
## # # * * * * ** **
  * #    *#   # *   
        *#  *  * *  
*#*     ***  *** *  
#   **  #   *##     
 # * *   1       #* 
    2#*# **     **#*
 3 * #   **  #   # *
***    *#* *    3   
 ** ##**#*#   *#    
 *     *   #**#  # *
  1   *  * p    #* *
**  *#  *        *# 
  ** #     *    *   
 1  # 2 *   *##  *# 