800 20 20
*  *     #  *  #*   
*3 *** * **#*#   3  
   **   *  #  * *##*
 #*  p    *  # # **#
3  2#**  2  #     1 
  # #* 3** #  ##    
    ***   **  #* *# 
#  2   * #  # #*   *
 * ***#   3 *  2 ## 
*  *  #*   * **    *
  1#      #* ** **  
#  ** *#  ** #  **  
     *  *    * 3   1
*   * *   #  #** ** 
# 3* 3 * #* * *  ** 
 * *   * * 2   *1 *#
 * ##* **  **  #   *
      #  #3 * *#  ##
   *    3   **    1 
 * ##   ** #    *  #