55 20 20
      *      1 ***  
   * *   *#   ## ** 
** #  #* *  *  **   
*   *   *  *   **#**
# * ***#       #    
* *# **  * **   *# *
* *       **     # *
 #  #3      1*##  *#
*   #   **   #  *   
  ** *  # 2  #    *#
  # *    ** #  *  * 
  2 ** *   # **#  # 
 #   #    **  1 #* #
*  *  p*  *  *   ***
  *     1  1#   #   
#  *#       * ****  
 *  #* *  *****#*  #
  **   # #* **# ***#
 #  *  # #   #  3  #
    #*  2  * #    # 