80 20 20
   * 1    ** * *  **
*   *  #* #*  ##*# *
 *   * *       *  # 
    *   1     * *#  
 *   #*# #* *#*# ##*
3  *#     * * * **  
  *  ** **    #     
##  *#   #  ** 2 # #
** * #  **    * *#* 
# *            **   
 3  #* **   #      1
    * * #*  #   1   
     #*   #  2*  #*#
*  ** #   *   #* * *
       1 # * * **  *
*   **  #   ***  *  
 *2  *#* **  ### *# 
 # ** * p*# **#* *  
         #* ** *  * 
  ###  *   *      # 