72 20 20
         *#**# *    
 * * p * #      **# 
** #  # 3    * *    
**# * * #*    *#   1
#   *   **   *   *# 
  #   **  * #*  *   
 ** 1 ** * #*     * 
  * * *    **#* **#*
#     #****   ** * #
* *## **  #*        
     #   **# #*    *
  #*#* * * * **1   *
   * * 2 ## *    *  
#1   #* #    ##*##  
             * * *#*
  # 2*  # #  2   ***
 * #   *  *     *   
# * *## 1 *      ** 
 3  #     ##      *#
   * * *#**#   **   