13 20 20
     #  *  *    ##  
 **    * *     **   
 # p #    #    #*#  
*  * 1 * *#  1**#   
 *1    **# *# # *   
   ** #   *  ##  ** 
#* *  *  *    * *# #
 * ** #   *  #   *  
# **   #*#* 1#*  #2 
#      #***     ##  
##**  1     *** * * 
 *  #  # * *       *
  ****  **  3   *   
#  * **     #  *  * 
 #    *## *  **  ** 
 *   * * 2**  *2  * 
 # ** # * *#  #     
  ** **   *# # * *  
*** 3   * #   *# #  
      # *** #   *   