131 20 20
 #*  #*  p *   * 2  
*     3     * 3#  * 
 ***   *#  * #      
  ** 2   *#  * 1 #* 
#  * **#*  #* * * #*
* #  * # * **3 *#   
 3* * #**  3  #   * 
*  * *  #*     **** 
#**   *   *#     1  
 *  # # # *#  *#* * 
   *    **#   *#*  *
*#**3 ** ** *3  #   
   *   *  #*  *  ###
* 3#  *#  ** *##* 2 
**  #  * * #* #     
 #  * *#   *#   * #*
  1   1   #   #  #  
        2  * 1  *   
 #* *3 * # * *  *   
#*  * # *   2 **  3 