87 20 20
           ** *  #  
**1  1  #*  #  **   
     *  #* # # **** 
 * #* *    ## ** #  
*# *##   * #   * * *
      **3 *  1 *  * 
   *        * **  * 
## 3 *2  #    **2   
 **    *##    *#   *
*  # #  #   ##    * 
*2 *  *  *  # ## *  
   *****#    *      
 ***    ** **** p#  
*    * **   *  #  **
 **   ## # #  *  # *
 *  *#*  #       ***
   ***  **# *     # 
#   # #     # # *#  
      ***  * 1      
** *# #** #* *   1 #