986 20 20
*  ** *  *   *  #   
##   #  ** *  *   1 
  *  ##   *    3* **
 3  **  *1  3   ##**
 #*#  #*   #     #**
  *# *  * ** #3 *  *
2    *   ***** * *  
 **  #  2  *#     # 
  *# ** #*   ** # *#
     *   # 2 #   3  
* #* # #* ##  *1    
*1   ##  ***    #*  
#  *# *      **    p
   #**  # ##  1  3  
  ### **** *** ** # 
**  *  *#     #  * 3
**# 3 *     3*  **  
  #* * 2         *  
 #  **   2   ** *  *
   #*** * *##  *  3 