727 20 20
#  *   #  2   # 2 * 
   *    #    1*    1
*  *  1 ##*   * *   
 #2 *  * * *  **#   
    p ###*  3*  * #*
 3**      **  2 ## *
* * # ** 1 * # *   *
 *   * # *# *  # ** 
 # # *#* * *   *    
*  ## * 3*    ** * *
 **# * * #  *  *   *
2  * * *#  #  3 ** *
  * 1  ##   # #  #*#
 # *   #*  *    * * 
  *  *   3  *  #*  #
 3 *3  # *#* *  * **
 *#  *#*    # *# #  
 # # *  **# 3 * ** *
 3 * * * 3    *** * 
   # *     *#       