20 20 20
 * # *   **   *    *
    #  1* #    #    
*  2     #   *#*    
 #   *#*     **     
  #   *  #  *  *  * 
*     **   ***   # #
#  *   #  #*    *   
 * #   **  *##*#  *#
  # 2 #  **#   #    
 *    *   *    # #* 
##**  1  * *1  *2 #*
** *     *#* #3   # 
 * # p ** # #    ** 
 * *****#*   #* # **
     *   * *    #   
 *#    *##*#   1 ##*
 #** #   *  *   **  
*  *  **  3**  * *#*
   **  *#  *  *   1 
 **   *  * * #  ** *