88 20 20
*    *    #* #      
#*  2 *1 #      *   
 * #*#  *#* * **   #
 ** ##***    *** * #
 ** # *  * * 3 *    
#      *#*  # * #** 
* #    *#*   * * ** 
*# *#  # * #*  * ** 
 *  2   # * ** *  * 
#    # # ***** * #  
 * ** *    *  #### *
 **   #   #*# # *   
       1  ## # *   *
   **#  #    * *  * 
#* # * *#  2* **  * 
    *  *        *   
 **#  * 1  * *  p  #
   *##     #   *    
 3    *   1       1 
 #  *  *#**    * *  