85 20 20
*    *   *    *    *
  1   *  *## * * *# 
 * **# #*#   *#  * *
#*  # *#    1   1   
   *  #*  * *** #***
    *    *  * # * # 
  1#    #   *#* ** *
 *    *#  2      #  
      #    **#3     
# *#   *  ##*   *   
# p # *** * # *#* **
 *  ** #* # *  *   *
**    2 * *#   *    
# *#* *   #**  #   #
   2 **#1  *#       
  #       *   ** * #
#  # #  * *  #*  #* 
  **     *   #*** #*
*    *  * 3 *       
*#* *  *  *#  * * * 