54 20 20
      *#* **#    ***
 #*1  * *# # ##*    
*      #   #* ***** 
     ** 1 #    *   *
* *   ## *** #*##   
#   2      ## p *   
 *     # # *        
  * **#  #**     * *
     * 3# ***     3 
*  *  *  *  #**  # #
*  *  #  *  #*  ##  
* *  *   *# *    # *
 ##** #  *#    # * *
*    * *1 *  *   * #
  *   #*  *** *     
  * *       * ***1 *
*  #  # * ** ##   * 
*  *  *   2    1**  
#  #**     #  * *  #
 *   #  2   **# #  *