441 20 20
   ** *  *  #   #*# 
* # * 3 * 1 * ***   
* #    *     ** *# 3
**  p*# * #*   2  * 
  #    3 *  #    ** 
   #  *#  *# ***  ##
* ** 2  #* * # * 1 *
 # * *         #    
#  ### *## * 2**  # 
***#* * *  #      #*
 3     3  1 #   #  #
*  * * # * #**# ** *
*  #*   #**#    ** #
 3  #1 * 3  *    *  
   3   ## *#  ** * *
** **##  # 3 #  *   
* ** *   *#  * **  *
#  #   **       *2  
 * * 1   3  * * * * 
*   *        2   *  