984 20 20
   # 2     #* #  ** 
 ***# *  1  *** 3 # 
 * 1 #  *#   **   * 
    # 3**   *  #   3
2  * * *# 1#   *    
 *# * *##     *##***
# **    #  # *  *#  
  *      #*   3     
3     *  *  **  #p  
 ** 2 # **   3     3
    *   #***#   **  
 #   *#   *    *  3 
** # 1   *   1#  # *
**  # * # 2     * * 
 #  * **# # * **#** 
 #  ** * * **#*# 3  
#* *     ## *  *  **
* * #2  *  # ** *   
*###*  #   * *#   3 
  **   * **#   * * *