70 20 20
  ### *      # **   
*** *#* ** #**#** * 
 *  **# ** *        
#     #  * 2 *  #   
 * #*   * # **2  *  
  ** p# * #      ** 
 # #    *  #**   #  
#   # * *# *#   # * 
*   # *           * 
* *  *   **** 3     
*   ***## #*   * ** 
 1     * ##** #*    
    #   *   # * * **
* #  ** *    #*# *# 
   ****3   2*  * # 1
     #    # ****1 * 
***    * 1  **      
   # * # #*      *##
 ** 1 *      #   #*#
 *  *     # #       