73 20 20
# * * *    *  ##    
*# #   # ###     *  
 * **     * *    ** 
 ***# * 2*  *# **   
    p *   # **** * *
# #* #  ##  *  #  **
 1#  **##  #* * *** 
   # *#  2*#    **# 
* *     *   * *     
  # * 3 *    * #**  
 # #     * *     ***
*     **  *      ##*
       ** #*3   1*  
   ** *    *     # #
***  2#* *    *# # #
**      ##     *# * 
 *       * ****  # #
#       **  # *1    
*  1    * 1* *#  ***
   *# *     * ##    