41 20 20
  #*  * ** *# #  #  
 *  ## 1        *  *
 *   ##** *     ##  
**# #*  2 #        *
  **   *  * * ##*#p 
   *# *#   * *  *#  
*  *   *#      *#*  
  * #  3  #*   *  1 
  #  *  *  #  2*    
# **     3     * 2* 
#     * #*  ** **   
     1  * #**  ** * 
**  * *   # ** *** #
  *   ***  *  *  *  
 # **  *## *# * #  *
 *  *##   #*# *    #
  ***    1    1    *
   #* ####  **  #   
* **# *  **  *   ** 
   #  # **  *   *   