669 20 20
      2  3 #  *    #
 * *3     **  * * **
  #   ***# #3 #3 *# 
 *   3  *#   #   *  
  # # *  *#**  # * *
** #   *   **# ***3 
**#** #* **  #*    *
 #**  *  * * * 3* * 
    *   *# ** # *1  
 * * **  # #* *## * 
  2# *  # 2* ##*#** 
     *   #    3    *
2 *   *##  * #   *# 
    ##  #1   #    #*
 1  1 * # **3 * *2  
*  *  * p *     * *#
 *  *     * *  *    
  *1   #    3     * 
#   *  #   * *   **#
 # *## **   *  * #* 