28 20 20
** ***  *  * #  * ##
** **    # **   #** 
 *  *#** #*  #      
     * # **#** #*   
 #   *3  *#*  *   * 
*  *#* #* 3  #*   * 
   1     *  1*   ** 
*#           * #*#  
 *       *  *   # * 
#   # 2* #   #  #   
 **     **#** #* p* 
    *   **   *      
*#*  ##**  *#   #* #
    # #  *#**  * *##
    *    # *   #*  *
  *2    **    #*    
 ** #* *  *   *    *
 #*# 1     # * 1** #
* 1 * *# 2 # *   *  
     *  *#  #   *   