34 20 20
  #  *   1   *    ##
 * *  *     ** * * *
 # # # *  *  *   ** 
#*#* ** #*#         
*  **   * **  #**  3
#  *#  **  ** * #   
     #*     *  #*   
*  * *#     ***** ##
   1  *     **    *#
***  # *   *   #1 #*
    *    *##*      #
#    #  **  *  #   *
** *1  # #    ** ** 
*  *   #  #*  #**#  
 2    #     **# * * 
 ## * * # * #      #
 *  * *  *#* p   *  
* 2 *   *  *#*  **  
 * # 3    #*# * *   
    *   2 ##*   # 1 