540 20 20
#     * # #  #      
 * 3   #  * ** #1  *
**      * *  *      
 #  * 3  *  3#*     
#*       * # ** 3 * 
* # #*     ** ***   
   1   2#*2 * ** *# 
* * **#     * *  #* 
*3 *  * * * *  **   
# # #* *  3 *  * ***
 *  #   ** ** *  ***
2  #*#  *#*** * #** 
   *   3      # *#*#
 3#   *##*# 1  3    
   2 ** ##  #*#     
* # *    #  * p  # #
#    * *  *    #  2 
# * 1 #  * ***#    #
 #*  *  3*  1 **  #*
  *       #* *  ##**