911 20 20
* #  *   *  1 * #   
* ***#** #   * 3*# *
  # * #**#  # *    *
 *  2   *   #** 3 **
   #  #   3  **  #  
#**# # 2  ##3   *** 
     ***   #   **  #
 *#* ** # **#  #    
 #  **  #3   ** * * 
2  *   **  *  # * #*
 #** *** * 1   3 #  
 3      # #  * # #  
  * * 2     * #** p*
*  1   * * #  3  #  
  # **   *#  * #2 * 
 #* *  **  **  * * #
 *    #       #   3 
**   *    3#** 1    
 * *  #1    *     ##
   ****   #*   #** *