33 20 20
    *## **  *#   *  
* 1   **  * *  #*  *
* ** # # #*      1 *
# *#  2**  2#   #*  
*# # # # *# * *1  * 
  #*  * #*** *    ##
**       * # 1 *    
*    *  *** #   #  *
 * *          *#*   
  *   # #* #   *#*  
* * *     * 1  *  **
   # **   **        
*3  #  * *    #     
#  **##  # *#**   * 
#  *  *    **  p  * 
 #***   *3  ** ## * 
** #      * *  # *  
*  # **# #  **** 2  
  #       #   *    *
*  # *  #  *#   *   