61 20 20
#*    #  *#  *      
    *** #     # #   
 **    * *# 3 * ##* 
## ** #***#**  p #  
*  *****   ** *  #  
    *#   *  #    * *
**     2 *    *   * 
** ***   **   # * * 
   ** #*#* # *   ** 
* *#  **    #   *** 
     **   **  *1    
   **#     ##     * 
2 #   * *#1   1 *  *
  # #*#    ##*##    
 *#  *#  #  2 #** #*
    #  * #         #
     #* 3*   1  *#  
*   1#     #   *  * 
 * *  **  * * *##   
#   * *     * *  ***