51 20 20
#     *   #**       
 *   *  *        *  
* # # *#*      2# 1*
*##* # *    ##  *   
**# ##*  #*  *# **  
 * # # #  #   # # 2 
    * *# #* * #     
  *  **    3 *   # *
* ****  * #   *    *
*    #**  #  * 1   *
 * *1   *    #* **##
 *   *3    * #** * *
p #*   # *2  *    # 
  ***   *  #* * #***
    1   **     # *  
 *    ## *#  ***#  *
     **      ****   
* * *    #   ###* * 
 # *  *  * **   # * 
* *  *#       *  1  