364 20 20
**# 1       *#  **  
* 1  *3 #  ** 2 #  2
     * #      * *#  
*** # *#  **     #* 
*  **# **   p *3 *  
 #**    *# ***# **  
3 ##  3 #* *   #  * 
 * ***#     #*    **
* * * ## * # ** 2 # 
  *  3# #     * #   
  #*  ## *    # #* #
##  *# **   ### * 2*
  1    *#  *  * 3   
    * # *  * 3     *
*2    1   3 # *  * *
  ** * **   * # #* *
  * *   *##*  * * * 
#  ## 3  *   *  *   
** *   #   **  #   1
    * ** *   *  3 * 