486 20 20
       *# *  ** * * 
 * **   *1   1  *   
# 3 # 3   **   3  2*
#  # *# *    ***    
    2 ***# *## #*3  
* *#      *** 2*   *
 **  3 * 1  #   **##
     *   #*#   3** *
#** * #*## *  *  2  
  *    *#* #   *# * 
  ** 2 #  p*  3  #  
   ** ***    * *# 3*
* #     3 * ***    #
*# #* *  *   # # 1 *
   *       * #   * *
 *     #     # 3 *  
 # # # *#*     #  1 
*  # **## #** *** # 
*** **  #    *#  *# 
 #  ** # * *        