97 20 20
    ***       *  *  
 #  *  ##* *  *     
    ****  *#*   **#*
*#  **             #
 * #*      **    1  
   ##    * *#  *   #
 *    *   ##  *   * 
 #3    #   **       
      #  1**  *** #*
# #*#   #   #   #  *
 *   *2      1 **# *
**        * # *  ** 
# 2 #** #* *   # #* 
  ***   *# ##   *#  
 ** **#  #1 *  2  * 
 #       # * 3 *  **
* # * 1   * **** ##*
*** **     p#* * # *
   # **   * *   ##* 
   # ##***  ** *    