66 20 20
  #   *        #  * 
 *### ** # *   #**  
#*#  1 ##*  **   *  
   #*       #  * 2 *
 ## **    **  # *  *
  *# *    * **  #  #
##  2 #* *   #**  # 
          *    *   *
 #*  #      *#   # #
  ** * **  **#  *# *
#   1#*  ## p # *  *
** * *  * #* *  3   
**  #* *#1 *# *  ** 
     # *   #  **  * 
     *#     *     * 
* *3 * *#     # *   
*   * # ** **      1
  #*      *     2#* 
* ** **  * ** *    #
   **     1 * #** **