60 20 20
 * #*  **  *  *# * #
#  **  * #*  ** * # 
*## # #  3 # **  ** 
*#   1 **  ** # *  3
   * # *  **        
*      **** #* **  *
      # #  *  *  *  
*    *    # *    **#
  * **  ** *  *  #  
2    * * *1   *  * #
   * # *#       1*  
#*#* #**          # 
 # *    #   *       
*** p** * *  *    * 
 #   ** # * 2   #*  
##  #  1 #*    *    
#   ***   #     ## #
##   *###  2  # * 1 
  *   *  *  *   ** *
 # * #  **   * * # *