357 20 20
* 3  **#   #*  ** # 
     # # # #  *## 2 
**  * 3**       ##  
  1 *#  ** #3 * * * 
 #  * #   **   #* **
 *      ** * *  **#*
  ** 3 *   # *   *  
##*#*   * * #* ##   
 *    1   3 *   * * 
  **   # * * *  #3 #
1 *    *  *  p *   *
    *#   *##   # *3 
* #*  * *  #  2**   
 *  2 *   # #  *#   
   *  *## *  *  *3  
 1*   2  * **      *
#   #   # # *# 3  1*
 ****** 3  **   #  *
#  *  *     **# *#**
*#        2 #* *  #*