74 20 20
 *  *## *   ##   *  
  *p     **#* *2  #*
    *# *#    #   **#
  # *   * #** *  *# 
*     #   #** *    #
**  *#    *#*   *# #
  *   ## 2 #    ** #
*  # 3* * *  *   * *
    *  ##   * #** # 
**#  * **#*    *#   
   * * * * 1# #  *  
#  # #       *   1  
 ***     #   *      
*  *   ***  * 3  * *
* * * # #   *     # 
*   #    2    #** **
 * 1  *  ** 1# * #  
 # * 1 #     **** #*
# ****     *     ** 
*   *    **   #     