74 20 20
  *  * #  2 #* **#  
 1  * **   *  #    #
*#* * ###***  * p * 
     #*      **  *  
 ** *  1  * #    *#*
 * *** *   * ** 3  *
     #  #  *  **    
*#    1*#    * #** *
 #         3  *  *  
** # ***#2   * * *  
  **#   *  #  #  # *
#* #  #  * *  *     
 #*   **  #** ##    
   #*  * #     *  *#
  *   *   *#   * *  
* * *# *  # 1 *  ** 
 *#  * 1  * * ####  
 *  # *  # ****  2  
 #   **    #* *   *#
*     #  #  #       