22 20 20
*  * ***      *  *# 
 * #  ** #**#  1    
    3       *    # *
**** *  * # 1 **    
* * ** **#   #  * **
  *  *#  *   #   # *
1   #  * *  * # #  #
   #  *  1  #*#   *#
 #** ***   *    #* #
**   ## * *#* *   * 
   * *  ** #*      *
 #**   *   **     # 
 p   *  * * #* # #*#
    2   *# 1  *    *
  # **   ##       #*
  *** **      2* # *
  *    3 * #   *##  
#  * *  *# **  #  # 
  ###* *        # 2 
  **  ** *    # *   