845 20 20
*     ***  #* #  ** 
#1 * *   * * **   * 
# # # # *  #     ** 
 *  #   * *  *  **  
    *# * **   * * 2*
 #     # 3 ##*##    
*    * 3    ####* * 
    ***  * *  #  2**
 * # *   #   #     #
p  *#***   3*  *##  
 *# 1   #*  * 3     
 **   #     *  *# 2*
*      1 **  3  #   
   3  *#  ***  * ##*
 *#   *  ** # *   3 
 3  *#*  * #*#  1   
* # *  *# 2   **#*  
 **  3* #*** * * #  
   3   2  *  *   ** 
 #*   ** 1 ## #***  