13 20 20
  #  *   ##    **   
*** **   *    ### *#
        #* **1   *  
2 * 3 **  2#  ***   
   * **#    3  * * *
#*1   *#*#   * *# **
*   *# *  *  # *   #
  *# *#    #p    ** 
 # ##   1**   # #  *
  **# *  * * *     *
  * ***#  1  *2     
 *#      *     * ## 
*   * #    1 #  **  
 * #    *   * **    
  ##  ###      *  * 
 *#* *    #    *  * 
* *       * **#*    
  *    **#   **  * *
 # #  *## *    # *  
##  **  *  * ** **# 