842 20 20
   #*  #   *# *     
** #  1# #** *#  ***
*****  # ***3 #2    
*#*    *  *     * #*
*      2    #  #*#**
*  * 1  *     ##  # 
*3      *   #   *3 *
    *******  *  #  *
3 ***  ##* *#*#**  *
 *   *  *#    * **  
 *3 *  3    1 *# ##*
*#   p # *  #   * **
 * 2   **  *# #  3  
 * *#    **  3 **  #
 **   #***#    *  1*
       *  * 1   #   
# 2    # *  ** #  * 
##  *     # * 3# #  
  *  2  ** *    #   
  #  ##   3 #*     *