430 20 20
#* ****# *   *   ***
 3       # *  3   * 
  #*  **  3         
 #   ** * *#* ****  
## * 3  # #        *
*        3  3** 1 * 
**  * * * #*   #*   
    #  * #*      *  
  2# * *   * # **  #
 #   *3  ##   *** 3#
** #*      *#****   
* ** 1** 2*   2  * 2
   *  # # #*** #*   
  #   *p # * *  #* #
**  3   **    #*# 1 
* 2 #  #   ## # **# 
    #    1# * # #   
*#*  #*#* #* 1*  ** 
 3      *  #  #   #*
*  *     *  * ** * *