503 20 20
  * *    1    #*  # 
 **3 * #* *# 3 ** **
    # p         3   
## * ** ***   **  * 
     # ##* * #**  **
  #   *    * *  1* *
*    3       #**    
  #  # 2  *1  #    *
 2  1* #  * * *#* * 
* *  *   #  **   **#
 # **  ## *   #*    
 *   *    1 ** *3 * 
*  # # **#  *    *# 
**2  * * #*  2 *   *
*  *  #*2  3*     # 
  * *    #   * * # *
#* 3 #**#*  3    *  
 #*  ** # *#   3  # 
#* * *#  # * 3#* ## 
 ##*# * #   *   **  