43 20 20
           #*  #*   
* #* **   * *     2 
    1  1    *     **
*   ##   2#*#   ## #
* * * *#*  #*    ***
**   * #   *  # # * 
*     * #* *  ** *  
  1# #* #   *   *# #
*  * #  *#  ***  ** 
  *  *  * *  #**  * 
 ###* 1 **  **  #*  
 ***  *  #       ** 
   *  #    ** *  *# 
 * ##   *     **   *
*    * **3  *** #*##
#   * #*#   * #     
  *  **  *   # p  1*
#*       #  *#*     
* #   * 3  #   *   *
 2  # **#  #    *  #