1 20 20
 *   *#*      * *#* 
     1 *     ##  #* 
*  *   #*  *#       
  *  *   p#  *#    *
  #*#** # #  * # #  
 *      1 * **1   * 
  *  #       *  ** #
* **    *           
  # * *   # * **    
**  * # **** *    * 
 ##     # #*#   * ##
    *#  ** # # *   *
   #    #*  *  #*   
     * **        ** 
#      **     * *#  
  #  * **  # *#* * #
   **   #*#  * #  * 
 **#   *#*#   ## ** 
# *** * # #* * *    
     **  * * ****** 