32 20 20
     * #* 1 # *  *  
#***#*  3    # #   *
   *  *# #     # *##
 **   *  *  2    #* 
  #*  *   #    * ***
* * *       ## ##  *
     **  * * #   **#
  #   * *# **** # * 
   *   **## *  2*# #
 * * #     1 *      
* # *#           *  
*  1  *#*3 #  1 # * 
  #  * *  *  *   *  
**     **  1* * ** *
 *** *#  ** *  *   #
 *#  **#   #**   # *
   *  **   *  * #   
   * *    # *p   2 *
  #    ** ##*  #   #
 # *#  ** #*     *  