44 20 20
 # ***  * #     1  *
# ***  *  # *     **
 *#  *   2**  * #** 
  * #  1# ***  ***  
 # * *#    #    **# 
  **#*    *#**1   * 
 **  ##* * #        
  **#*       **3    
       *         *# 
** *# ** * **## #   
# 3   *       * *#* 
** * ** #  * **  *  
**#  *#       1    *
*    ***  p     ##  
* ###  # #*   #* *  
  #* *  * **     # *
 * # 2 * * #  # 2   
 #  #    #**      #*
 #    1      #*# *  
 *  *    #** #    * 