602 20 20
  *   #   * 3 *    #
##*#** 1  #    3  1 
* * # # *3 ## #*  * 
    #*     # * * *  
  1#*  ****  # # * 2
    **# # 3 * # *   
 ##3        * *  ***
3 * #  3 ****#****# 
   #* *#* 2       #*
** **   #     *#*   
# *# # p* *# *# *# #
   *#          3 *  
     **** 2    *    
 **  3       #* 1   
 ** *   2  *  #*  1 
   #  *** ***   *#**
**#  * ***#  #*   * 
  2 *  # *  3  **   
   #    * *  *#  # *
*   **    #* *  * # 