622 20 20
   * ##***#* *** # #
** **    #  #  * *  
  #  * **    3  1 #*
  #***#*      *#   *
* 3  *  *# 2**    * 
   ##  3  #      **#
**   * *  *  **   * 
  # * 3 #1  3# # #  
 * 3* # *    ##   # 
    *   ## * ** #***
  #*#  3 * ** *     
##*      ##   *  *  
* ***    *  *  *  1 
* *   2*#** 1   *   
     *    p  *2  2# 
*** 3  *** * * #*   
    ##   *# ## #* * 
 # 2 *# *# *  # *  1
   *  *3 *  3  * ** 
   ** # *    #    * 