476 20 20
   3 *  *     #*#***
 #*  * ** *** *   * 
  * 3   *3 **     # 
* # * #   *  **  *#*
#* 3#  # #*#    1  #
##  * #***#  ***  ##
** * p# *   *  *# * 
   *     1     **   
 # * * # *#*#  2 * *
  *     2* # ** *   
 * * 2#* *  *# *  1 
* #    *   * #  **  
* # 3#**3 #*  # #   
 3    #  ** 2      *
   1*  3       1* ##
  *   * *  #        
* #*# *  *     ** # 
  * *# #*#* * 2     
 # 3  ***  3# *  *# 
  * *  *#     #*   *