77 20 20
#  # *  * #         
  p# *  ** 1   2 #  
   *#   #  # ##*  2*
 *     #* * **  *  *
 *   ** 1 **  #  *# 
 *  3#   #* 1 #     
* #  *   * ##* **** 
#  *  #** *  # 2    
#*   *#*   **#  *  *
   *  #  * **#     *
*     #* *  *     #*
 # *# *     # *  * *
         * *    1 * 
** ** *   * ** *  ##
   *   *  * #  **   
* *  **#   *# **   #
 ##3  *       #  #*#
* *      1 *#  **   
* *# # ** ***   #*  
   *#  #*   *  #   *