71 20 20
   1 * ## *   * *# *
1 * ##**  *   *     
  #   # #   * ** # *
 *  *   *  #* #**# *
  #**     * * *   * 
       **# #   # *  
      2* * **    *  
*   *      **#*#**  
   2   *    #*  ##  
*## **  * #* # #*   
  #   * * *##   * 3#
#   *  *     # *    
 2 *  *  3* 1*** 1  
* *  *  *  *   # #* 
    *# * ** #*  * # 
 **   1  ##      #  
 #** **#*# ** p    #
* * *      #    * * 
*#  **  **  *#*   # 
     *  * #*#  *    