82 20 20
          **#**     
* * #1   *  ##    2 
# #** #* *# ## # *  
*   1      #*   *   
 *       ** **      
# *  #*** #   2    *
  *#*     * 1#*** **
*2 ** *  #*      ** 
   **# #*  1   **** 
#         **  3     
 * *####     *  #  #
  *   **#**  * # *  
 *##     # ****#  p*
 #  #* **** ###  *  
       #  * *** #  *
 *  * **   #*  1 * *
     *     #*  #   #
#** #  #  * * *    #
 # *  *  *  *  * ** 
     # 3 **      *  