637 20 20
   # 1 ** **# 3  # *
 * *  **## **  # #**
#    ****   ***  #  
   *# # *   ** 3#** 
 2 * * 3 #   ##     
   *   #   *  3 # * 
##*  ** * # *  # #* 
  *#  * # * 2  *** #
   *3  **# #  1  * *
* ** ****# *   ***  
 #       * *   ##   
   #  ## ##* *  * 2 
  *** #*    *      #
 #  #2  *  p#***   *
 **   * 3 *  1    1 
  * 1    #      * * 
  3     * #  **  #* 
        #3 **# #* **
  *2  3*    # #  3  
 *  **   # *** *  * 