56 20 20
    *   # 3    #    
* *  *   * *#2   #  
 *#p   # #*#      2*
 #* # * #     *    *
  *   #*** *# # *#  
*   3 # * # *#*     
# * *  ** *1 * ###  
 # **   *   *    *  
   **  * #   *##* * 
 # * #* # *  1    **
*  *  * ***   *  *  
#   #*    ** * * # *
# *  #* * * **##* 1 
 * 2   #*    ** **# 
   * **    ##*#     
*  # * *  #*   *   *
      # *    * #   #
  **   1*** * # *   
* #  *#    #  * * * 
  * *    *  1    *  