135 20 20
  ** *#*  *#    **#*
 **  *   2*** # #   
  # # * * #   3 ** #
*** #**#     *  1 * 
 3 #  #** 2  *   ** 
  * 2    *** #  #  #
   #*  * *   * *  **
 3     #****3 * *** 
   *#  *##    *  * 1
*#     *  #  *      
  2   ##  **# 1  ***
   *## * # *#  *    
*     **##     * *1 
* 3  **#   ##  *3   
 #### # 3         **
  * * * * ** **# 3##
3   ** *   *#       
 * **#  #  p   3* 1*
*  *#  *  #   *     
#     2   #  *    **