8 20 20
 *#*##  *  ***      
     * ###*    *##**
*    #  #  *  *  *# 
  1* #  *    #*# * *
     *# * #* #   *1 
**# *    *         #
*#  ** *   ## *     
 #*  *   #*    **  *
*  #*  *          * 
*    *# 1 *   1    p
   *    ***#**  *#* 
  ** * # #  # *  *  
*  * #    * ** #    
     2    # 2 #** # 
#** *  2 # *   2  * 
 ** *  * #  * * *  *
  *  *  #*       *# 
*#*      **  #    * 
# #     ** ##***   #
  **#    #**    *** 