575 20 20
  #  1 # #  * *  *# 
 3  *   *   p **    
 ##** *  1** *  2*  
3  #  2   # *       
 *# **         * # #
  ** #   2* * *   **
3   *   *  *  * 3 # 
  2 *   1  **** * * 
 * #  *#    *#** 3 *
* **  3 #* * #*   * 
 #* *  *# 2 #* ##  1
*    ***      3  #* 
* **   # *#   **** #
*   * 3 * * #  *  1*
##  3      * #*  *  
  *     #   *     # 
*  *    * * *   *#* 
* # *  * ## * #* * 3
  # * ***  #*    *# 
  # ## # *# # ##*# *