98 20 20
    #*  1 #  *# * * 
**   * *  ** # 2*#  
# * # *# #*  *    **
 #   *#   *****     
****# *   *   * *   
 **      *          
  **  * *  * * #### 
    *  *  ***  * 2 *
*#    #  **  # #  * 
* ***  *   *  ##    
** *# 2   *        *
 #  #* *  #*  1   # 
3  * #* # *  * #  ##
 *  1  # # 3#  * *# 
*   #**  **      #* 
*    #**    #    # #
* *   * # #*#  *  # 
***  *   p *     #  
   1* * *    1* *  *
 *# #  *   *     #  