59 20 20
  2 *##* *   * #*# *
 *     ## p** * #*  
 **** *    #  *   * 
 #    ***** * *#*   
 2        #*   #  **
     **** **  #     
#***  #* *#   ** #* 
*   #   ##*       * 
* *       *    1## *
 1    * #*    * *   
#     *     ***   * 
#  * *  *  *  2 *   
 #   **##  *#*  3   
*   1     # **   **#
* *#**# *#*    1#* *
 #   #      *      *
 *   *3 * *   # *  #
1 #     ***# #**   *
 #     #  #         
# *    *#   #* ##***