471 20 20
**     2 **#*  *    
    1 * #*   * ##** 
#2  ##  #* #**  * * 
   #   *   ** **# # 
*   **#   2 #    #  
#  3*# 3   # 2** ** 
*#* *  ## * *  #    
   #  #  *    ** *#*
*1 * #* *#* # ## *  
       **  3 * ***#*
* p #* # * ***  #** 
 *      3     **  # 
 #* *  *   *   * * *
     #3   *   **  **
## 3 # * *   *  1# *
 #*     3# 1 * *   *
#  * **      3   2 *
 * ** *  #  *   *  *
#  #   *1 *  #3  #* 
#  **      3   *    