73 20 20
    #     **        
    #      1   * ** 
 p  *  *#    * # ***
     #* **  3#**   *
  #**#   **    #   *
* *  *    * * *#1 ##
*1 * #   2  *  *  * 
#       **#* #3  *  
    *2  **   *   ## 
 1    ***  1 # * * *
*      *   #    *  *
   *     ** * 2  ##*
  *#   # *  *    *  
***  #*#**# * *    #
 # ##  #  *# ##   # 
**  # # * * *#* ** *
 #*#  *  #*  *      
*#* *   #   *    * *
   #** #   #**  **  
# *   **   **  #  *#