16 20 20
   *#  *  *   2     
* #*    * **   ###  
 # 1 **      *  2 #*
 *   **  * #   * *# 
#** ###  ##* * *  # 
 *#****#  #*   **  *
   #  *      *  *  *
# * ## * **# *    **
   *    #* ##  #*#  
 *      *    # *    
1 * * #  *#* * **  #
          1 #    ** 
 1** *  p   *****  *
#   # 2  *   ****# #
 **# # #*  *  #  3  
3  **       1**   * 
 *#   *#   #   **   
#  * *    *#    #** 
** *  **#    * * # *
       *      *     