46 20 20
 *      #   #  **  *
# **# *  1 *  *## * 
    **  #    ** * # 
 p       *    * *   
 *  *1     #* 1  * *
        #**#*  *  * 
#  *  **    *    # #
#* #* 2   *2 # *# #*
* #     * * ** * *  
 #  **  # #   3  ** 
 * **#  *  #**#*  * 
 *  **#  # **  #* *#
  *#  *#   * * **   
#  #   *   1 *  **  
**  #   #      *    
    # #* *     #2 ##
**  *  * ** ** # *  
   #**  *    #*  * *
 *   * *# *  *   #* 
#   3    1    *###  