65 20 20
   *   # # #     * #
* **   *** *** 1*   
   *    *# * *  #** 
*   #  *      * #*  
*  # *#*   p       *
 **#    *  ** 3     
    # * *#* **  * * 
  *   #* #*  * 2  1 
    #*  #   **# #*  
#* *    #        * #
  *   ****  *#**1  *
  **   #*  #*  *  2 
 *   *     *#    *# 
*   *     1  * #  # 
 #      3 **        
 * * **  **  #   ***
1 * #  *   *  ** # *
   **** *##  2  *#  
  ## #*# #*# ##*  *#
 #   ###* *  #  *   