188 20 20
* ***  **#   3  ### 
  *# #     #  **#*  
*  2 *  *****# #* * 
* * * # #*## # #  * 
* *#  *   ** #  3  *
 * * *  1 #  *   ** 
   #*#*    # p **   
 **  1  *#  *   *#**
  **  *    #  1  #  
 *        # # * * # 
3     3 ** 2*  *#  3
   #  #   #      #  
**  ** #* * *3    * 
   # #*   #3    *   
*   3 * * *  * 3 *  
 1*   *  ###   *** *
* *  ** **## 1 #    
   #  ***  2  #  2  
 *  * # *   *  2* * 
  3  **#*   * * #* #