830 20 20
*#    #  *  ** *###*
*#* ** **  2  2 ** *
* * *  *  *#   *  p 
#  *  3*    *3    * 
 # *   *2 * *  * *  
 ***3 #  *    # #* #
*# * #*#* ##*  #   *
# *###  * *   ##*#  
 2     * *##  *    3
  #**  *    *   **  
 *      #  * * 1    
  *    #     **  3  
**   2  3    3 *  * 
 ## ***#***1    * # 
3   *     *  # 1  * 
  * #*#*  *** *  *  
 **#*    * #    3 #*
* * # **#   * * **  
   ##* 3  1   *  # #
  1     ##   * #  * 