16 20 20
# *     2          *
* *  * #   ** ##   #
    3**# *1 #    #*#
* *   ***# *   ***  
 *   1 *  *   # *   
 #*   ## **   #*  *#
  #  #     **** *   
*  *    * # # *#  **
# **      **  * 2 **
 *  #    #     ***  
* #* #  #  *     * *
 #  *  p * * * # # *
2    *  *   *  **  #
 #     ## # #*      
  3 #*##   #  # #** 
    #****** #  *# **
#  *#      **   * **
   *    1  *  * 1   
 *     ***** 1*     
 *  *  # ** # #    *