81 20 20
 1 *** *#   **  * **
* ** *#  ##*   *# # 
#      *   ** 3#    
   *#   *#        **
  *   *#****   2    
  *       1      #* 
*#*#*   #     *     
   *# *   #*  # 2  #
  #* *##  *  1      
 #    *#**   #  * * 
  *#   ** ##**#* #* 
 *##  * #   #*   *  
* * # *  # #   ## **
*3  *  **    *  *  *
   * **   ** *   *  
 #  # *  2 *  # #  *
1   * *  *   #*  # *
 ##*      1##    *  
 #  ** *** * *   * *
     ***      *** p 