29 20 20
*   *  * ##*        
*   * 3 *#     * * *
    ##     **      #
** # *       # * ##*
     *  ##  # * 1* #
 #    *  #* *     1 
**   #* * *  **   *#
   1*     * *  1    
**  * *    * * *  **
 *   * ##     * *  *
  *#**   # *  * **  
2 *# #  * ***   #*# 
  * *  #*# *  p ** *
 #*#  *  * *  #    *
   *  1    *#    * *
* *  * #**   # #   #
*#    #  # ##*# * 3#
 #*  * *      #*    
 ** *  * **   #**2  
* # ## *   2    * # 