26 20 20
  ** *  *  # *     #
 ***  #*# * ***1  1*
#  #p  #    *    *  
 *      #   *      *
*   #     * ##**    
#       * *** # **  
 #      *  *  2  1  
 * #     * ***     #
# * *    * *   ###* 
 ##*   ** * # 2  *  
   *#      2** #   *
# *   3  1    * **  
** #*  * *   *   ## 
 3 *   * # * #   *#*
   #*    ***   *   *
 * * #    *# #*#* # 
# # *#* **  *    * #
  * * *#  * * ** #  
 **#  #    *   #* 1 
* #  **   **#  #**  