97 20 20
    *#**      *   #*
*#**# ** *##**** ***
   1         #* 1 * 
*      *  3   * *   
*     * * **    *# *
**  * *  #*  ***    
  * ##*#* #   # 1  *
 *      #  ** #     
 *     *  2 *   ##**
#  *# *    ##   #   
# *  * **p   *  ##  
## # *    * # ***   
 *  *###** # *   2 *
# *  # **    **   **
 *  *  *  * 3   #  #
  *       *## *  * #
*        # *  *1 #  
#  1*       **      
*   #    *#* * *** 2
 #   # *#    *#   * 