10 20 20
      ##*# * *  *#  
*   *  *#*  2 #*  **
 *   ##*  ****#* *# 
  2* #  *        #  
 * *  1 * * 3   *   
    #   # **  *# ** 
# 1  1     **# *#   
       # # * *   *  
   #   #**2   1 #   
   *  #  *  #  * 3##
*# *** #  *  #*   * 
* * * * * *#  #* ** 
* *     **# #  # #* 
*     * *          #
 *  *##   ** * * #1 
  ##  *#         *  
 * ***  * * **  # **
 p **   *    * *  # 
   **       *#*# ** 
# **     ** # # *   