714 20 20
 #* *   *   *#  #  *
       ** 1 *   * * 
   1 *2    *  *#   1
#*   #  * *  **#*   
*     # *   3* #  * 
*   * *  **# * #3 # 
  3#** #3 #   #*  #*
** ***3     **  #  *
  * *# * 3* * # **  
 * 3    *  *  * *  *
    # *2  1  #* ** #
#*** 2      #* 2 *# 
 *# *    *     *   3
 **2  *#* # ## ** * 
# #  3  *  *  #  ** 
*#   *   * *#   *  #
 *#  ** p *  * * *  
  *   *#   ##   1   
 #   * * #*  ***  3 
  *## # ##*     # # 