87 20 20
* ** * # *      # * 
 3 * * * **#        
**    # ** ## * #*# 
#  2   ##*#  3  ** *
   #*  **  * *     #
 #* * *     ## # **#
*  * *  *  #   #**  
*    *  *    #   **#
  **   #  # 1 * ** #
***#* #*#2 # *     *
   #  *   *   ##* * 
  *   ##*     #  *  
*    p  **   *   *  
* *  *** *    *  *  
   1*##   * ***   *#
##*     * # #*  *   
 **   *    *     # *
   1      * # 1 * *#
#     1# ** * **  2 
   *        * # *  #