40 20 20
  *** ** #  *  *#   
#   3 ** * *   **  *
**    * # * #   *  *
#****#  * # *     * 
  p   * #   * * *  #
     # #  # *       
 *      #    #  # * 
     1 #  **#*  * *#
   * ###  ## 1 **# *
  ****  2##   *   1 
#*     * *    2 **  
* #  *#     #   #* *
  *   **1       ## *
   1     *   **  * *
2 *   *    ## #* * #
  *** *  *** #**  * 
 #*       *#    ***#
 *   #  * ## * *    
   #* * #   3 #  #**
** #  ** *  **      