47 20 20
* *  ***#    # * # *
 #  # #**  ##*   ** 
* 1 *  ***#  2 ***# 
#    ***# # *       
   *  ##  #     2   
#     * ** * p*   3 
  #   *  #* #  * #  
 **  * ** * # **#* *
 *  #  ** *   *# *# 
 *#*   # *   *   1 *
*   # **2  * *     #
   *      *##**#*   
   * # #    * *** * 
*  #  #  *    **    
*  * * ## #*   #    
 1* *#     #*#** *  
*   *  *  3 #* ** # 
    #1  *   * #  1  
    *     **       *
#  *   * *   *  #   