63 20 20
 * ** *   #  * ##   
#  #   1 *    *  # *
*#  *      #      **
*       * 1 *  *   *
 ## 1  * *   #   *# 
***#* #  # * *# * * 
 *       #*  #    *#
 ***    **   # *  **
   ****# ** *  #* 1 
 *  2 *   ***    # #
 *#   1  *       3 *
*    * *#** * *    #
   #3 **  **  #   # 
**        #  2# *   
*  #*  2** *     ###
 *#*    ***   **   *
 *#* *     *    *#**
     * *  ##*  **  #
  p     #  #*      #
*    **#  ##* # *#  