64 20 20
 *   ***  *#***  * #
 #*  *# # #  #  **  
 ** # #* ** * 2     
    * 1  **  *  *#  
*#1  #      * # *   
*      * ##   * * *#
  * p  *   *    # #*
     *  * # *     * 
*****  #     3*#    
  * #    * #  * #  #
 *   * #* 2*# ***   
   #   *** *#   *  #
#  * #         ** #*
*1     * *# *#*     
  ** ** *   * #**  *
    #     **     #**
 *   ##*   # #* *   
 #  #*** *2 *** 3   
  ##   **# * 1     *
 1  #  *  # #      *