763 20 20
#   *    *    *     
*#*2 *     #*  * 3*#
      * **#   1 * * 
 #   p* * # * **  * 
 * *    * # #*# * **
* *      #    #  3  
*  ** * 3*   *##***#
    *  *  3  1    *#
     3* ** #   ###  
   *    *  # * **#2 
  **#  ## #*       *
*   3   *##   2# *# 
 1#   *   #3 * * # #
# ** *  *##  ** #   
  * 2 #     2 ***   
*   *  *****# * **# 
*#*#  *****  1  ** *
  #  **  ##3  ##  3 
 1 *** 3       *   *
 #   *    *  *   * #