19 20 20
 #   ***     #  #   
  ##* 3  ##** *   * 
 *   #   *  ** #  *#
 **    #*** # 1     
 p  *      ***#** #*
* *#*  *# ** *   * *
  #* #*#    ##***   
 *** # *  *** ## *1 
 **   *  *##    **  
 ***# **    *# 1    
 *    *  # *   *  **
  # #** # *  ****  *
 3   2      *#* * * 
 #  *    2 *   # # #
 **  *** *  #       
               #    
 *1  ** * *      * *
        1 *  ** 2   
  # *  *   #* #   *#
 #    # #  ##   #* #