27 20 20
  2 # *   #*   # ** 
** *  # * **    *   
 # **   *# #     * #
*** #*         #  * 
 ***  #  # *2     # 
  ** # #*      * *# 
    * * *** *#      
#    * ***  1  # ***
 3     * * *  **  * 
#*  * * 1 *   **##  
* **  1     *  * ** 
#      #   * #    * 
 * * **#   # 1   # *
 # *    * p # ** ***
 *#  *       *#   * 
 *   * # **  **     
   #*# **  1   *#* 2
  # * * ###      *  
   * 3 #    **  * ##
 # * ### ##    # * *