17 20 20
*# # * ** ##*      *
*     #   ***  *#  *
  * #* 2 **  3*** * 
*  ** ###   * # *   
*   *      *#*# #*# 
  * 1 **## * *      
 *     #  # #*   ***
p   *   #*#   **    
  #   *  * #2 #*** *
    ** #  *       * 
*  *       *   * *##
 *  *3 *#        * #
 **##  #   *   2#   
   # ##    *  * * * 
* *     * *  #   *  
**  #  ** * #*#*#   
#  *# 1 *  1    1 * 
   #*# * *    **  * 
   * #**  *        #
*  #  **#     1  * *