854 20 20
 #   #   ##* *#  3  
2  * 2  *#    * * * 
 #  * * #  * 3 # *  
** * * * 1#   #* *  
 *     **   3  * #  
##**** *  *  *** * *
 # *  *  * #  #  ## 
 #* *   1 *   # #  2
  # **3   3 * 1   * 
   ##  #** * * #   *
  3 # *   ## **# *  
*  * #   1 *#       
*  # 3 #   # *#     
*     *** ## ** p   
 **  #*    2  3   **
  #* * 2**  *# * 1 *
**   #  * 3      * *
**#  **    *  #*#***
  #*           3  **
#*#* *  ****  * #   