58 20 20
    # *#   2 *** #  
***  *  3   *    ** 
*  #*    ** * #   * 
   ** **** #  # #*  
 1  ** #**3        *
   *       *#*##1   
  *# * #     #*  *  
    2*  * *   *#  * 
 #*  *   *# **  *   
   * #   *  # *# * #
**    *    * ** 1  #
   *   #** * **    *
  *## #* 1  **      
 * 1  *   #   ** 2 #
* #  p**    #   # * 
*   *  # *   *  * * 
 ##  #   ###   #*   
#      *### # # *** 
   * # * **  * #*   
   *** *  *  *  *# #