17 20 20
*# * **  ##  * *#   
*# #  *##  **   3  *
##**##  *# # * * * *
# #**  2 #   *# **# 
*    **#  #   *     
   *   * * # # * *##
   # *  1***     *  
 *    *#      ##  * 
#   #  *   # *#*    
 #**  * * *  * ** *#
  # *   # ** *   # *
  *   2 *#*      * #
#   * * ** * *  * 1 
 * 3 * * *    *     
       * *          
 *      #***   1  **
*  *    1    * #  * 
 1   #** *2   # **# 
 *  *# *** *p *     
#*  *  *     #  #   