327 20 20
   *         2  *** 
 * #   2  #**  **# #
*** 2 **#*  1    * #
 #  #   # *    #  * 
   * *#* 3  **      
*    p ##  *  2    *
  1*  *#  **** *  ##
    3  #   * *  3 * 
* # * # * *# * # *# 
* 1  *      *#  ##**
    3 * * 1 #** # **
*     * 3     *   # 
#*3    * ** * **#*  
        ** *  #  * *
   * *     * * *#   
 3#    * 3 *   # ** 
# * 1 ** #* 3##*  *#
 *  #*#* **  * 3 * #
 *  #* 2  #**    ## 
##   ** # # * *   * 