48 20 20
 ###  * *  * * *   #
# *  * #  #* #2     
* * 3     *         
* #    # #*  *     *
   *   #   *  # **  
* ***# * **  *     #
**  *    *   *  **# 
    #  * ** ## 2  * 
*##* #*    *  *     
# * ** **### ##*####
  *1   *   **  *  * 
 *#  * * *      1*  
  **#   ##* * *   * 
*   *   ##*#* *     
  #*  # *    *  ** 3
* **  1 * * p* #  # 
 *         *  *#  * 
#      2   #*  1 *  
 * 1**  *   # # * # 
*   *   * # ** *   *