732 20 20
   #  *****  ***  1 
  2  3     *# #     
***  # 2#  *   *  * 
    #*      2    # 3
  *# *# #2    ##    
    * * * # #1 ##  *
1 ### *** *     * 3 
  * ##  *  *#  ** # 
#* * *   * * * **  *
* 3  * * ** *  *# 3 
 #  # ***   #   #** 
*  ** *   *#  *##  *
 #* ** **  #   # 3* 
* *1 *#   *  * *    
 *    *  3 #**# **  
     #   * *#   3  #
 p * *   # *###* #* 
  *****  1  ***     
 *##  *     *  3  3#
 * *#  2   **       