15 20 20
    #  *   * **   # 
*  3  2*     ** **  
 *  #  #  ***   * *#
  * *1 #   # *3 #  *
#*    **#*  ** # #1 
  # #  * *      #   
##* **   # * * ** * 
*# 1  * # #  *#  p  
   * ** *   #* *  #*
   *#   **   *#     
 1    * *# **      *
   *   * *#   # **#*
          * **     #
# ** ***  # ** * 2# 
# ** *  #       *   
 2 **   # * * *  *  
# #   * *   # * # * 
*#    *    * **# *  
**   #   **    #  ##
    1   *##  ** *#  